90
0
13
5
3
0
2
1
+F+X+F+C+
FXTXTXFXT
+F+C+F+T+
XXTXXXTXF
XX+F+F+T+