35
11
84
10
9
1
2
1
+F+F+X+F+X+F+F+X+X+
FXTXFXXXFXFXFXXXFXF
+F+F+F+F+X+F+F+F+F+
XXTXFXXXFXFXXXFXXXX
+F+F+X+X+F+F+T+F+X+
CXXXTXXXTXXXFXXXFXX
+F+F+F+X+F+X+X+F+F+
XXXXTXXXFXFXXXFXTXX
+F+X+F+T+X+F+X+F+F+
FXFXXXFXXXTXFXXXFXF
+F+F+F+X+X+F+F+F+X+
FXXXXXFXFXTXXXTXXXF
+F+X+T+F+F+F+F+X+F+
XXXXFXFXXXTXXXFXXXF
+F+F+F+F+F+X+F+X+F+
FXFXXXTXFXXXFXXXFXF
+X+X+F+F+F+F+X+F+X+